{----------------------}
:++++++++++++++++++++++;
:++++++++++++++++++++++;
:++++++++++++++++++++++;
:++++++++++++++++++++++;
:++++++++++++++++++++++;
:++++++++++++++++++++++;
:++++++++++++++++++++++;
:++++++++++++++++++++++;
:++++++++++++++++++++++;
:++++++++++++++++++++++;
:++++++++++++++++++++++;
:++++++++++++++++++++++;
:++++++++++++++++++++++;
------------------------