_b_a_b____________b_a_b_
________p_______________
_______hm_______________
_______h________________
_______hm_______________
________________________
________________________
_________c__c_______d___
____________________t___
____________________u___
________________________
________________________
__ht_j____ht_j____ht_j__
________________________
________________________